25
350
-gg              g                                                        g
-   gg              g               g            g                                        g g  g g 
-      gg              g               g           g                                      g      g
-                         g                          g                                    g      g
-         g   g              g                         g     ggg                          g g  g g
-          g g                  g                        g     g          g g             g g  g g
-           g                      g                       g     g         g              g      g
-                                     g         g            g     ggg                    g      g
-g g g            g                      g         g           g                          g      g
-                g         g                g                    g                        g g  g g
-                 g                             g                  g       g